[方案]
方案名称=自定义

[零声母标识]
=

[声母]

[韵母]

[音节]
fa=fj
bang=bm
bei=b;
ji=jd
bin=bk
cou=co
cuan=cm
gun=g;
wa=wj
cang=cg
fei=fi
li=ld
jin=jt
chou=uq
chuan=ur
qun=q;
za=zm
tang=tm
gei=gs
mi=mz
lin=lt
dou=do
duan=dm
run=r;
wang=wg
hei=hs
ni=nz
min=mt
fou=fo
guan=gm
sun=s;
a=ah
chang=ug
lei=ls
pi=pe
nin=nt
gou=go
huan=hr
tun=t;
dang=dg
mei=ms
pin=pt
hou=hq
juan=jr
cun=cc
fang=fh
nei=ns
qin=qk
kou=kq
kuan=kr
chun=uc
cha=ua
gang=gg
pei=ps
xin=xk
lou=lq
luan=lr
dun=dc
hang=hg
wei=wi
shi=is
yin=ek
mou=mq
nuan=nr
hun=hc
kang=kg
zei=z;
bing=bp
nou=nq
quan=qm
jun=jc
lang=lg
ben=bk
ding=df
pou=pq
ruan=rm
kun=kc
mang=mg
cen=ck
yi=ei
jing=jf
rou=ro
suan=sm
lun=lc
nang=ng
chen=ut
ling=lf
sou=so
shuan=ir
shun=ic
pang=pg
fen=fk
zhi=vi
ming=mf
shou=iq
tuan=tm
xun=xc
rang=rh
gen=gk
dia=dx
ning=nf
tou=to
xuan=xm
yun=yc
sang=sg
hen=hd
xia=xl
ping=pf
you=eo
yuan=em
zun=zc
sha=ia
shang=ig
ken=kd
lia=lx
qing=qp
zou=zo
zuan=zm
zhun=oc
yang=eg
men=md
jia=ja
ting=tp
zhou=oq
zhuan=or
cuo=cp
zang=zg
nen=nk
qia=ql
xing=xp
er=eh
chuang=uz
chuo=up
zha=oa
zhang=og
pen=pk
bian=bl
ying=ep
guang=gz
duo=dp
bai=bh
bao=bj
ren=rk
tian=tk
jiong=js
huang=hz
guo=gp
cai=ch
cao=cj
sen=sk
dian=dw
qiong=ql
chu=uf
kuang=kz
huo=hb
chai=ux
chao=ub
shen=it
jian=jw
xiong=xl
shuang=iz
kuo=kb
dai=dh
dao=dj
wen=wk
lian=lw
diu=dq
zhuang=oz
luo=lb
gai=gh
gao=gj
zen=zk
mian=mw
jiu=jq
jue=jb
nuo=np
hai=hh
hao=hj
zhen=ot
nian=nw
liu=lq
hu=hf
lve=lb
ruo=rp
kai=kh
kao=kj
beng=bd
pian=pw
miu=mq
ju=jv
nue=n;
suo=sp
lai=lh
lao=lj
ceng=ck
qian=qn
niu=nq
ku=kf
que=q;
shuo=ib
mai=mx
mao=mb
cheng=ud
xian=xn
qiu=qo
lu=lv
xue=x;
tuo=tp
nai=nx
nao=nb
deng=dd
jiang=jg
xiu=xo
mu=mv
yue=e;
zuo=zp
pai=ph
pao=pj
feng=fd
liang=lg
nu=nv
cui=c;
zhuo=ob
sai=sh
rao=rj
geng=gk
niang=ng
sui=s;
shai=ix
sao=sj
heng=hd
qiang=qh
ang=ag
pu=pv
zui=z;
tai=th
shao=aj
keng=kd
xiang=xh
mo=mq
chui=uv
wai=wh
tao=tj
leng=lk
biao=bb
po=pq
dui=d;
zai=zh
yao=ej
meng=md
diao=db
gui=g;
zhai=ox
zao=zj
neng=nd
jiao=jj
shu=if
hui=hv
ban=bn
zhao=oj
peng=pd
liao=lz
o=oh
kui=kv
can=cn
ge=gi
reng=rd
miao=mb
rui=r;
chan=uw
ce=cy
seng=sk
niao=nb
yo=eo
shui=iv
dan=dn
che=ue
sheng=id
piao=pj
cong=cl
yu=eu
tui=t;
fan=fn
de=dk
teng=td
qiao=qj
chong=us
zhui=ov
gan=gn
e=e;
weng=wd
tiao=tj
dong=dl
zhu=of
han=hw
zeng=zk
xiao=xj
gong=gl
gua=ga
kan=kw
zheng=od
bie=by
hong=hl
hua=ha
lan=ln
die=dy
kong=ks
kua=km
man=mn
jie=je
long=ll
shua=im
nan=nn
lie=lz
nong=nl
zhua=om
pan=pn
re=ry
chi=;i
mie=me
rong=rl
chuai=ux
ran=rn
se=sy
nie=ne
song=sl
guai=gh
san=sn
she=ie
pie=pz
tong=tl
huai=hx
shan=iw
te=ty
qie=qy
yong=el
kuai=kx
tan=tn
tie=ty
zong=zl
shuai=ix
wan=wn
ze=zy
xie=xy
zhong=os
zhuai=ox
yan=en
zhe=oe
zan=zn
zhan=ow
dei=ds
